10,10
*,*,*,*,*,*,*,*,*,*
*, , , ,*, , , , ,*
*, ,*, ,*,*, ,*, ,*
*,*,*, , , , ,*, ,*
*, , , ,*, ,*, , , 
*,*,*, ,*,*,*,*, ,*
*, , , , , , ,*, ,*
*, ,*,*,*, ,*, ,*,*
*, , ,*,*, , , , ,*
*,*,*,*,*,*,*,*,*,*