9,9
*, ,*,*,*,*,*,*,*
*, , , , , ,*, ,*
*, ,*,*,*,*,*, ,*
*, ,*, ,*, , , ,*
*, ,*, ,*,*,*, ,*
*, , , ,*, , , ,*
*,*,*, , , ,*,*,*
*, , ,*, , ,*, ,*
*,*,*,*,*,*,*, ,*